# This file is an example of a test map file in the .cub format.
# The following is a simple representation of a map for testing purposes.

NO ./textures/test/north.xpm
SO ./textures/test/south.xpm
WE ./textures/test/west.xpm
EA ./textures/test/east.xpm
F 220, 100, 0
C 255, 255, 255

111111
100001
101101
100001
111111
