NO textures/simonkraft/cobblestone.xpm
EA textures/simonkraft/cobblestone_01.xpm
SO textures/simonkraft/cobblestone_02.xpm
WE textures/simonkraft/mossy_cobblestone1.xpm

F 120, 110, 100
C 10,10,200

11111 11111
10S01 10001
10001 10001
10001110001
10000000001
11100001111
11111001111
1111100111111111
1000000000000001
1111111111111111