NO textures/simonkraft/netherrack.xpm
SO textures/simonkraft/netherrack_01.xpm
WE textures/simonkraft/netherrack_02.xpm
EA textures/simonkraft/soul_sand.xpm

D textures/simonkraft/bookshelf_01.xpm
O textures/test/south.xpm
F 18,53,25
C 153,204,255

111111111111
100000000011
100000000001
11111D111111
10E000000001
1111111D1111
110000000001
111111111111
