NO ./textures/north.xpm
SO ./textures/south.xpm
WE ./textures/west.xpm
EA ./textures/east.xpm

F 220,100,0
C 225,30,0

1111111111111111111111111111111111111111111111111111111111111111111111111
1000000000000000000000000000000000000000000000000000000000000000000000001
1000000000000000000000000000000000000000000000000000000000000000000000001
1000011111000001111100000111110000011100000111110000000000000000000000001
1000010000100001000010000100001000010010000100001000000000000000000000001
1000010000000001000010000100000000010010000100000000000000000000000000001
1000010000000001111110000111110000010010000111110000000000000000000000001
1000010000000001000010000000010000010010000000010000000000000000000000001
1000010000100001000010000100001000010010000100001000000000000000000000001
1000011111000001111100000111110000011100000111110000000000000000000000001
1000000000000000000000000000000000000000000000000000000000000000000000001
1000000000000000000000000000000000000000000000000000000000000000000000001
100000000000000000000000000000000N000000000000000000000000000000000000001
1111111111111111111111111111111111111111111111111111111111111111111111111
