NO textures/wolfenstein/grey_stone.xpm
SO textures/wolfenstein/eagle.xpm
WE textures/wolfenstein/red_brick.xpm
EA textures/wolfenstein/wood.xpm

F 18,53,25
C 153,204,255

11111111111111111111111111111111111111111111111111111111
10000000000000000000000000000000000000000000000000000001
100S0000000000000000000000000000000000000000000000000001
10000111110000010000100001111100000111110000011110000001
10000100001000010000100001000010000000001000010001000001
10000100000000010000100001000100000000010000010001000001
10000100000000010000100001111100000111100000010001000001
10000100000000010000100001000100000000010000010001000001
10000100001000010000100001000010000000001000010001000001
10000111110000001111000001111100000111110000011110000001
10000000000000000000000000000000000000000000000000000001
10000000000000000000000000000000000000000000000000000001
11111111111111111111111111111111111111111111111111111111
