NO textures/test/east.xpm
SO textures/test/east.xpm
WE textures/test/east.xpm
EA textures/test/east.xpm

F 164,169,20
C 153,204,255

1111
1N01
1111
